AAHED	AA D
ABBREVIATUS	AE B R EH V AY EY T AH S
ABRAHAM'S	EY B R AH HH AE M Z
ACAPELA	AH K AE P AH L AH
ACEH	AE S
ACIPENSER	AE S AH P EH N Z AH R
ACKNOWLEDGMENTS	AE K N AA L IH JH M AH N T S
ACQUISITIVENESS	AH K W IH Z AH T IH V N AH S
ACTUALIZED	AE K CH AH W AH L AY Z D
ADULATORY	AE D Y AH L AH T AO R IY
ADULTHOOD'S	AH D AH L T HH UH D Z
ADULTISH	AH D AH L T IH SH
ADULT'S	AH D AH L TS
ADVISOR'S	AE D V AY Z ER Z
AFFECTLESSNESS	AH F EH K T L AH S N AH S
AGATEWARE	AE G AH T W EH R
AGEISM	EY JH IH Z AH M
AHHH	AE HH
ALEXITHYMIC	AH L EH K S AH TH AH M AH K
ALGORITHMIC	AE L G AH R IH DH AH M IH K
ALINSKY	AH L IH N S IY
ALOK	AE L AH K
AMIA	EY M IY AH
ANANDA	AH N AE N D AH
ANDREI'S	AE N D R EY Z
APERIODIC	AH P IH R IY AA D IH K
APERIODICITY	AH P IH R IY AH D IH S AH T IY
APRES	AE P AH R Z
AQUAFRESH	AE K W AH F R EH SH
ARAM	AH R AE M
ARDY	AA R D IY
ARMAR	AA R M ER
ARMLOAD	AA R M L OW D
AROWANA	AH R OW AH N AH
ARPHAXAD	AA R F AE K S AH D
ARTA	AA R T AH
ARTAUD	AA R T AH D
ASRNEWS	AE Z R N Y UW Z
ASSOCIATIVE	AH S OW S IY AH T IH V
ATHOL	AE TH AH L
ATMOSPHERES	AE T M AH S F IH ER Z
AUN	AO N
AUSSIES	AO S AY Z
AUTEUR	AO T AH R
AUTOFLUORESCENCE	AO T OW F L UH R EH S AH N S
AYSE	EY Z
AZIZAH	AE Z AH Z AH
BABIED	B EY B IY D
BANDANNA	B AE N D AE N AH
BARENESS	B EH R N AH S
BATLINER'S	B AE T L AY N ER Z
BAUX	B AO K S
BEACONSFIELD	B IY K AH N Z F IY L D
BEANIE	B IY N IY
BEATIFIC	B IY AH T IH F IH K
BEAUVOIR	B IH AH V OY R
BERENICE	B IH R IY N AY S
BERT'S	B ER TS
BETROTHAL	B IH T R AO TH AH L
BEWAILING	B IH W EY L IH NG
BIDELTOID	B AY D EH L T OY D
BIONIC	B AY AO N IH K
BIOWARFARE	B AY OW ER F EH R
BISTATE	B AY S T EY T
BITCHING	B IH CH IH NG
BIZARRELY	B AH Z AA R L IY
BLOOMSBURY	B L UW M Z B EH R IY
BOSSING	B AO S IH NG
BOTTARGA	B AA T AA R G AH
BOTULINUM	B AA T Y UW L AH N AH M
BRADLEYITES	B R AE D L EY AY T S
BRASHLY	B R AE SH L IY
BRAYS	B R EY Z
BREATHERS	B R IY DH ER Z
BREEZIEST	B R IY Z IY AH S T
BRODIE'S	B R OW T IY Z
BRONDOLO	B R AA N D AH L OW
BUELLER	B Y UW EH L AH R
BUELLER'S	B Y UW EH L AH R Z
BUFFED	B AH F T
BULIMICS	B Y UW L AH M AH S Z
BUSYNESS	B IH Z IY N AH S
BUTTERFREE	B AH T ER F R IY
CABINETWORK	K AE B N AH T W ER K
CALEB'S	K EY L AH B Z
CANDELORO	K AE N D EH L AH R OW
CANDLE'S	K AE N D AH L Z
CAPPUCCINOS	K AE P AH K S AH N AH Z
CARBONATION	K AA R B AH N EY SH AH N
CAREER'S	K ER IH R Z
CAREGIVERS'	K EH R G IH V ER Z
CARETAKING	K EH R T EY K IH NG
CARSTENSEN'S	K AA R S T EH N S AH N Z
CARTWHEELED	K AA R T W IY L D
CATALYSIS	K EY T AH L IY Z IY Z
CELERA	S EH L AH R AH
CEMENTS	S IH M EH N T S
CENTEREDNESS	S EH N T ER AH D N AH S
CEO	S IY IY OW
CERULEUS	S AH R UW L IY AH S
CHALCOFF	CH AE L K AH F
CHANGEUP	CH EY N JH AH P
CHATTERBOX	CH AE T ER B AA K S
CHELLY	CH EH L IY
CHERYL'S	SH EH R AH L Z
CHESIMARD	CH EH S AH M AH R D
CHILDISHLY	CH AY L D IH SH L IY
CHILDISHNESS	CH AY L D IH SH N AH S
CHUB	CH AH B
CIPHERS	S AY F ER Z
CIRCULARITY	S ER K Y AH L AE R AH T IY
CIRO	S IH R OW
CIVILIZATIONAL	S IH V AH L AH Z EY SH AH N AH L
CLARITECH	K L AE R AH T AH K
CLAYBURGH	K L EY B AH R
CLUTCHLESS	K L AH CH L AH S
COCONSTRUCT	K OW K AH N S T R AH K T
COCONSTRUCTION	K OW K AH N S T R AH K SH AH N
COEVOLUTION	K OW EH V AH L UW SH AH N
COEVOLVE	K OW IH V AA L V
COEVOLVED	K OW IH V AA L V D
COEVOLVING	K OW IH V AA L V IH NG
COGNITIVELY	K AA G N AH T IH V L IY
COHOSH	K OW HH AA SH
COLLIN'S	K AA L IH N Z
COLOUR	K AH L ER
COMBINATORIAL	K AH M B AY N AH T OW R IY AH L
COMPANION'S	K AH M P AE N Y AH N Z
COMPARTMENTED	K AH M P AA R T M AH N T IH D
COMTE	K AA M T IY
CONDI	K AA N D IY
CONTEXTUAL	K AA N T EH K S CH UW AH L
COPELANDS	K OW P L AE N D Z
COUNTIANS	K OW AH N T AY AH N Z
COURTEOUSLY	K ER T IY AH S L IY
COWAL	K AW AH L
COWERED	K AW ER D
CRADLED	K R EY D AH L D
CREEDMOOR	K R IY D M UH R
CRONENBERG	K R OW N AH N B ER G
CUEING	K Y UW IH NG
CUKUROVA	K Y UW K Y UH R AH V AH
CULTUREBOX	K AH L CH ER B AA K S
CUPPED	K AH P T
CURRANT	K ER AH N T
CUTELY	K Y UW T L IY
CYBERPROPHET	S AH B AH R P R AH F AH T
DANILEWICZ	D AH N IH L UW AH K Z
DARWIN'S	D AA R W IH N Z
DAUBIGNY	D AH B IH G N IY
DAUGHTRY'S	D AO T R IY Z
DAYLIGHT'S	D EY L AY TS
DECEIVES	D IH S IY V Z
DECLINIST	D IH K L AY N IH S T
DECONSTRUCTING	D IY K AH N S T R AH K T IH NG
DEFORMS	D IY F AO R M Z
DEMYSTIFIED	D IY M IH S T AH F AY D
DENNIN'S	D EH N IH N Z
DERMABRASION	D IH R M AE B R EY Z IY AH N
DERVIS	D AH R V AH S
DEWEYAN	D AH W EY AH N
DIAPREPES	D AY AH P R IY P S
DIDJA	D IH JH AH
DISASSOCIATION	D IH S AH S OW S IY EY SH AH N
DISCONFIRMED	D IH S K AH N F ER M D
DISCRIMINATIONS	D IH S K R IH M AH N EY SH AH N Z
DISRESPECTFULLY	D IH S R IH S P EH K T F AH L IY
DOANE'S	D OW N Z
DODGY	D AA JH IY
DONMAR	D AA N M AA R
DOUBS	D AW B Z
DOWDILY	D OW D AH L IY
DREADLOCKS	D R EH D L AA K S
DRIPPINGS	D R IH P IH NG Z
DSHEA	D SH IY
DSL	D IY EH S L
DUANE'S	D W EY N Z
ECONOSPHERE	EH K AH N AA S AH R
EDDY'S	EH D IY Z
EISENSON	IY S EH N S AH N
ELDERCARE	EH L D ER K EH R
ELDERHOOD	EH L D ER HH UH D
ELDERTOPIA	EH L D AH R T OW P IY AH
ELKMANN	EH L K M AH N
EMINEM	IH M AH N EH M
ENAMELWARE	IH N AE M AH L W EH R
EPHEDRA	AH F EH D R AH
ESSAYISTS	EH S EY IH S T S
EXASPERATIONS	IH G Z AE S P AH R EY SH AH N Z
EXECUTIVEDOM	IH G Z EH K Y AH T AH V D AH M
EXPANDER	EH K S P AE N D ER
EXTRADERMAL	EH K S T R AH D AH R M AH L
FACECLOTH	F EY S K L AO TH
FARNAZ	F AA R N AH Z
FASCICULATIONS	F AE S IH K UW L EY SH AH N Z
FASSEL	F AE S AH L
FASSEL'S	F AE S AH L Z
FASSIHI	F AE S AH HH IY
FAULTLESS	F AO L T L AH S
FEARFULNESS	F IH ER F AH L N AH S
FEININGER	F IY N AH NG AH R
FERRIS'S	F EH R IH S IX Z
FILMSTAR	F IH L M S T AA R
FINITELY	F AY N AY T L IY
FIZZY	F IH Z IY
FLAXEN	F L AE K S AH N
FOALS	F OW L Z
FORAIN	F AO R AH IH N
FORGETFULNESS	F AO R G EH T F AH L N AH S
FORMWORK	F AO R M W ER K
FORTIFIES	F AO R T EY AH F AY Z
FOURTHHAND	F OW R TH HH AE N D
FRANCHE	F R AE NG K
FREELANDER	F R IY L AE N D ER
FREESERVE	F R IY S ER V
FRIEDA'S	F R IY D AH Z
FRISKIEST	F R IH S AY AH S T
FROGS'	F R AA G Z
FROSTIER	F R AO S T IY ER
FRUITINESS	F R UW T IY N AH S
FUGIT	F Y UW JH AH T
FUGU	F Y UW G Y UW
FULVESCENS	F UH L V EH S AH N Z
FUNCTIONALISM	F AH NG K SH AH N AH L IH Z AH M
FUNCTIONALIST	F AH NG K SH AH N AH L IH S T
FUNDSEEKERS	F AH N D S IY K ER Z
GALATERI	G AH L AE T AH R IY
GAMZATTI	G AE M Z AE T IY
GEHRY'S	G EH R IY Z
GELATO	JH EH L AH T OW
GENEALOGICAL	JH IY N AH L AA JH IH K AH L
GENOMES	JH AH N OW M Z
GEOCENTRICISM	JH IY OW S EH N T R IH K IH Z AH M
GIMBLING	JH IH M B L AH NG
GIRI	JH IH R IY
GLIMPSING	G L IH M P S IH NG
GLOBULE	G L AA B Y UW L
GOATHERD	G OW T HH ER D
GOOGOL	G UW G AH L
GOP	G AA P
GOPNIK	G AA P N AH K
GOURGONNIER	G AH R G AA N AY AH R
GRANITEWARE	G R AE N AH T W EH R
GUIGNOL	G UW G N AH L
GYRING	JH AY R IH NG
HABANERO	HH AH B AE N AH R OW
HADAYET	HH AE D EY AH T
HAIRBRUSH	HH EH R B R AH SH
HAIRPIN	HH EH R P IH N
HAIRSTYLES	HH EH R S T AY L Z
HAIRSTYLING	HH EH R S T AY L IH NG
HALEIGH	HH EY L EY
HANNAH'S	HH AE N AH Z
HANRAHAN'S	HH AE N R AH HH AE N Z
HARDINESS	HH AA R D IY N AH S
HARDWIRED	HH AA R D W AY ER D
HAYDAR	HH EY D AH R
HEARTHSTONE	HH AA R TH S T OW N
HEDGEROW	HH EH JH R OW
HELPGUIDE	HH EH L P G AY D
HERITABILITY	HH EH R AH T AH B IH L AH T IY
HESHAM	HH IY Z HH AE M
HISAKO	HH IH S AH K OW
HIV	HH IH V
HOMESCHOOLING	HH OW M S K UW L IH NG
HOOFBEATS	HH UW F B IY T S
HOOTING	HH UW T IH NG
HOUSEMATE	HH AW S M EY T
HUCKLEBERRIES	HH AH K L AH B EH R AY Z
HUMMED	HH AH M D
HYPERRESPONSIVE	HH AY P ER R IH S P AA N S IH V
HYPERTHERMIA	HH AY P AH R TH AH R M IY AH
IBM	IH B M
ICONIC	AY K AA N IH K
IMAGININGS	IH M AE JH AH N IH NG Z
IMMES	IH M Z
IMPENETRABILITY	IH M P EH N AH T R AH B IH L AH T EH
INFURIATION	IH N F Y UH R IY EY SH AH N
INGRAHAM'S	IH NG G R AH HH AE M Z
INTAKES	IH N T EY K S
INTEGRALLY	IH N T AH G R AH L IY
INTERNALIZES	IH N T ER N AH L AY Z IH Z
INTERSUBJECTIVE	IH N T ER S AH B JH IH K T IH V
INTERSUBJECTIVITY	IH N T ER S AH B JH EH K T IH V AH T IY
INVALUABLY	IH N V AE L Y UW AH B L IY
IRRADIATIVE	IH R EY D IY AH T IH V
ISOBEL	AY S AO B EH L
IZABELLA	IH Z AH B EH L AH
IZVESTIYA	IH Z AH S T IY AY AH
JAKOB'S	JH AE K AH B Z
JAMJOUM	JH AE M JH AW M
JAPHETH	JH AE F AH TH
JEROME'S	JH ER OW M Z
JERONIMO	JH AH R AA N AH M OW
JIMMYING	JH IH M IY IH NG
JOANNE'S	JH OW AE N Z
JOHNNES	JH AA N Z
JUDDERED	JH AH D IY R D
JUSTSYSTEMS	JH AH S T S IH S T AH M Z
KABOBS	K AE B AH B Z
KAHLID	K AE L AH D
KALKAN	K AE L K AH N
KALLIMOS	K AE L AH M AH Z
KANCIPER	K AE N S AY P AH R
KAROLKOWSKI	K AE R OW L K OW S IY
KAZAA	K AE Z AH
KEIZO	K IY Z OW
KERFOOT'S	K ER F UH TS
KFAR	K F AA R
KINESENSIC	K IH N AH S AH N Z AH K
KLIESEN	K L AY Z AH N
KNEELED	N IY L D
KNIGHTIAN	N AY T IY AH N
KONOHI	K AA N AH HH IY
KORO	K AO R OW
LADIN	L AE D IH N
LADIN'S	L AE D IH N Z
LALANNE	L AE L AH N
LATRELL	L AE T R AH L
LEBOWSKI	L AH B OW S IY
LEONSIS	L IY AA N S AH S
LESSAC	L EH S AH K
LIBATION	L AY B EY SH AH N
LIMBUS	L IH M B AH S
LODS	L AA D Z
LOVERLY	L AH V ER L IY
LTI	L T IY
LUTNICK	L AH T N AH K
MACROSTATE	M AE K R AH S T EY T
MACULAR	M AE K Y AH L AH R
MAGIONE	M EY JH IY OW N
MAGNIFICENCE	M AE G N IH F AH S AH N S
MAJELLA	M AH JH EH L AH
MAKEUPS	M EY K AH P S
MANHANDLING	M AE N HH AE N D L IH NG
MANLIER	M AE N L IY ER
MANTEO	M AE N T IY OW
MAPPINGS	M AE P IH NG Z
MARKHASEV	M AA R K AH S AH V
MARKSES	M AA R K S IH Z
MARYINSKY	M EH R IY IH N S K AY
MASLOW'S	M AA S L OW Z
MAULING	M AO L IH NG
MAXIMALLY	M AE K S IY M AE L IY IY
MEALTIMES	M IY L T AY M Z
MEDICALIZED	M EH D IH K AH L AY Z D
MERETRICIOUS	M EH R AH T R IH SH AH S
METROPOLISES	M AH T R AA P AH L AH S IH Z
MICROMETEORITE	M AY K R OW M IY T IY AH R AY T
MICROMETEORITES	M AY K R OW M IY T IY AH R AY T S
MICROPAYMENT	M AY K R OW P EY M AH N T
MICROPAYMENTS	M AY K R OW P EY M AH N T S
MICROSTATES	M AY K R OW S T EY T S
MIDDLEBROW	M IH D AH L B R AW
MIDDLEHOFF	M IH D L AH HH AH F
MIDDLER	M IH D AH L ER
MIDDLER'S	M IH D AH L ER Z
MIDDLERS'	M IH D L AH R Z
MIDDLERS	M IH D AH L ER Z
MIHALYI	M AH HH AE L AY IY
MILDVAN	M AY L D V AE N
MILDVAN'S	M AY L D V AE N Z
MIMED	M AY M D
MINTY	M IH N T IY
MITOCHONDRIAL	M IH T AH CH AA N D R IY AH L
MONOMERIC	M AA N AH M ER IH K
MONTSERRAT'S	M AA N S ER AA TS
MOOMBA	M UW M B AH
MORTUARIES	M AO R T Y UW AH R AY Z
MOTORISTS'	M OW T ER IH S T S
MOTTERSHEAD	M AA T AH R SH IY D
MOURNER'S	M AO R N ER Z
MOUSSAOUI	M AW S EY AW IY
MULTICELLULAR	M AH L T AY S EH L Y AH L ER
MULTISECTORAL	M AH L T AY S EH K T ER AH L
MULTIVALENT	M AH L T AY V EY L AH N T
MUSICOLOGY	M Y UW Z IH K AA L AH JH IY
MUTUALISMS	M Y UW CH AH W AH L IH Z AH M Z
NADAR	N EY D AH R
NAGOURNEY	N AH G AH R N IY
NAKATA'S	N AA K AA T AH Z
NEEKELLS	N IY K AH L Z
NELL'S	N EH L Z
NEMBHARD	N EH M B HH AH R D
NEOTENOUS	N IY OW T EH N AH S
NETFLIX	N EH T L AH K S
NETOSAURS	N EH T AH S EY Y AH R Z
NEUROBIOLOGICAL	N Y UH R AH B IY AA L AH JH IH S AH L
NEURONAL	N UH R OW N AH L Z
NEURONTIN	N UW R AA N T IH N
NGATI	N G AE T IY
NIGHTGLOW	N AY T G L OW
NIKIYA	N AH K IY AY AH
NINOV	N IH N AH V
NISHANT	N IH SH AH N T
NITISAROJ	N AH T IH S AH R AH JH
NONEQUILIBRIUM	N AA N IY K W AH L IH B R IY AH M
NONERGODIC	N AH N AH R G AH D AH K
NONHANDLED	N AA N HH AE N D AH L D
NONJUDGMENTAL	N AA N JH AH JH M AH N T AH L
NONPARENTAL	N AA N P AH R EH N T AH L
NONPROFIT'S	N AA N P R AA F AH TS
NONSPONTANEOUS	N AA N S P AA N T EY N IY AH S
NONSTATIONARY	N AA N S T EY SH AH N EH R IY
NUCON	N Y UW K AH N
NYROB	N IH R AH B
OBUCHI	AA B AH CH IY
OGEWO	AA JH UW OW
OLDTM	OW L D T M
OLIGOPOLIES	AA L AH G AA P AH L AY Z
OLMSTED	OW L M S T AH D
OMNISCIENCE	AA M N IH SH AH N S
OOHED	UW D
OPTIMIZES	AA P T AH M AY Z IH Z
ORIENTING	OW R IY EH N T IH NG
ORIENTS	OW R IY EH N T S
ORNANS	AO R N AH N Z
OSBORN'S	AO Z B AO R N Z
OTKIR	AA T AH R
OVERESTIMATION	OW V AH R EH S T AH M EY SH AH N
PACHYDERMATITIS	P AE CH AH D AH R M AH T AY T AH S
PAIKEA	P EY K IY AH
PAIKEA'S	P EY K IY Z
PAINES	P EY N Z
PANGLOSSIAN	P AE N G L AA S IY AH N
PARAMSOTHY	P AH R AE M Z AH TH IY
PASCAL'S	P AE S K AE L Z
PASTORALISTS	P AE S T ER AH L IH S T S
PATRICIA'S	P AH T R IH SH AH Z
PAVERS	P EY V ER Z
PEARCE'S	P IH R S IX Z
PEARL'S	P ER L Z
PERCEPTIBLY	P ER S EH P T AH B L IY
PERMED	P AH R M D
PERSONHOOD	P ER S AH N HH UH D
PHD	P IY EY CH D IY
PHENOMS	F EH N AH M Z
PHONIES	F OW N IY Z
PHYSIOLOGIC	F IH Z IY AH L AE JH IH K
PIPA	P IH P AH
PLAYACTING	P L EY AE K T IH NG
POCHOWSKI	P AH CH OW S IY
POKEMON	P AA K AH M AH N
POLENIN	P OW L AH N IH N
POSTREPRODUCTIVE	P OW S T R IY P R AH D AH K T IH V
POWERADE	P AW ER EY D
PREDEFINED	P R IY D IH F AY N D
PRESPECIFICATION	P R IY S P EH K AH F AH K EY SH AH N
PRESPECIFIED	P R IY S P EH K AH F AY D
PRESTATE	P R IY S T EY T
PRESTATED	P R IY S T EY T IH D
PRETEEN'S	P R IY T IY N Z
PRIAL	P R AY AH L
PROMISCUOUSLY	P R OW M IH S K Y UW AH S L IY
PROMOTER'S	P R AH M OW T ER Z
PROPULSIVE	P R OW P AH L S IH V
PROSODIC	P R AH Z AA D IH K
PROVOCATEURS	P R OW V AH K AH T IY Y AH R Z
PSYCHOSOCIAL	S AY K OW S OW SH AH L
PULVERIZING	P AH L V AH R AY Z IH NG
PURITANICALLY	P Y UH R AH T AE N IH K AH L IY
PURL	P ER L
PYRIDOSTIGMINE	P AH R AH D AA S T AH G M AY N
PYROTECHNICIANS	P IH R AH T AH K N IH S IY AH N Z
QUENCHED	K W EH N CH T
QUITA	K W IH T AH
RADIOSTERILIZATION	R EY D IY OW S T EH R AH L AH Z EY SH AH N
RAHMA	R AE M AH
RAJAH	R AA JH AH
RASHOMON	R AE SH AH M AH N
RATTIMA	R AE T AH M AH
RAYA'S	R EY AH Z
RAYING	R EY IH NG
RECHARGES	R IY CH AA R JH IH Z
RECOGNISED	R EH K AH G N AY Z D
RECOMBINATION	R IY K AA M B AH N EY SH AH N
RECOMBINATIONS	R IY K AA M B AH N EY SH AH N Z
REENGINEERED	R IY EH N JH AH N IH R D
REFASHIONED	R IY F AE SH AH N D
REFIRE	R IY F AY ER
REFIREMENT	R IY F AY ER M AH N T
REGRESSING	R IY G R EH S IH NG
REHEAT	R IY HH IY T
REJOINDERS	R IH JH OY N D ER Z
REMIXED	R IY M IH K S T
REPELLERS	R IH P EH L ER Z
REPETITIVELY	R IH P EH T AH T IH V L IY
REPHRASING	R IY F R EY Z IH NG
REPRISED	R IY P R AY Z D
RETINAS	R EH T AH N AH Z
RIKKIA	R IH K IY AH
RIMMING	R IH M IH NG
RINA'S	R IY N AH Z
RITUALIZED	R IH CH AH W AH L AY Z D
ROADKILL	R OW D K IH L
ROBESPIERRES	R AA B AH S IY R Z
ROMINSON	R AH M IH N S AH N
SALIE	S EY L IY
SANDLOT	S AE N D L AA T
SANDRA'S	S AE N D R AH Z
SAROP	S AE R AH P
SCORUPCO	S K AH R AH P OW
SEABIRDS	S IY B ER D Z
SEARCHABLE	S ER CH AH B AH L
SELDEN'S	S EH L D AH N Z
SELFISHLY	S EH L F IH SH L IY
SENESCENT	S IY N EH S AH N T
SENESCENTS	S AH N EH S AH N T S
SERVICEMAN'S	S ER V AH S M AE N Z
SHAKESPEARES	SH AE K AH S IY R Z
SHAWANO	SH AO AH N OW
SHEARER'S	SH IH R ER Z
SHEEPISHNESS	SH IY P IH SH N AH S
SHELAH	SH EH L AH
SHEM	SH EH M
SHERBROOKE	SH AH R B R AH K
SHIMMIED	SH IH M IY D
SHIPPIN	SH IH P IH N
SHOSHANA	SH AA SH AH N AH
SIBLINGS'	S IH B L IH NG Z
SICKO	S IH K OW
SIDEL	S IH D AH L
SIDETRACKING	S AY D T R AE K IH NG
SIMPLICITY'S	S IH M P L IH S AH T IY Z
SINGSONG	S IH NG S AO NG
SIRIONO	S AH R IY AH N OW
SLITHERED	S L IH TH ER D
SLOUCHED	S L AW CH T
SNAKEPIT	S N EY K P IH T
SNOWFLAKE'S	S N OW F L EY K S
SOCIOCULTURAL	S OW S IY AH K AH L T Y AH R AH L
SOCIODRAMATIC	S OW S IY AA D R AH M AH T AH K
SOLDIERED	S OW L JH ER D
SOLOR	S OW L ER
SONORAN	S AA N AH R AH N
SPEARED	S P IH ER D
SPECIATION	S P IY SH IY EY SH AH N
SPEEDWELLS	S P IY D W EH L Z
SPREWELL	S P R UW AH L
SPRINGY	S P R IH NG IY
STEIGERS	S T EY JH AH R Z
STEINLEN	S T IY N L AH N
STENOGRAPHERS	S T AH N AA G R AH F AH R Z
STEPPARENTS	S T EH P ER AH N T S
STEWARD'S	S T UW ER D Z
STINTING	S T IH N T IH NG
STREHLER	S T R EH L AH R
STURGELLS	S T AH R JH AH L Z
STUTTERED	S T AH T IY R D
SUBLIMATE	S AH B L AH M EY T
SUBOBJECTIVES	S AH B AA B JH IH K T IH V Z
SUBSTRATE'S	S AH B S T R EY TS
SUE'S	S UW Z
SUHAYDA	S AH HH EY D AH
SUMERIAN	S UW M IY R IY AH N
SUPPORTKIDS	S AH P OW R T K IH D Z
SURFEITED	S ER F AH T IH D
SUSPENDERED	S AH S P EH N D ER D
SWATHES	S W AA TH S
SWELLINGS	S W EH L IH NG Z
SWERVING	S W ER V IH NG
SWIZZLE	S W IH Z AH L
TAHITIAN	T AE HH AH SH AH N
TAIS	T EY AH S
TARMACKED	T AA R M AH K T
TASKFORCES	T AE S K F OW R S IH Z
TEARLESS	T IH ER L AH S
TEMPUS	T EH M P AH S
TENET'S	T EH N AH TS
TERRYS	T EH R IY Z
TETSCHNER	T EH T S N AH R
THEODORIDIS	TH IY AH D AO R AH D AH S
THERMODYNAMIC	TH ER M AH D AY N AE M IH K
THERMODYNAMICALLY	TH ER M AH D AY N AE M IH K AH L IY
THIRDHAND	TH ER D HH AE N D
THROBS	TH R AA B Z
TIGA	T IH G AH
TILLERS	T IH L ER Z
TIMBERED	T IH M B ER D
TITHONUS	T IH TH AH N AH S
TITTERING	T IH T ER IH NG
TOILSOME	T OY L S AH M
TOMFOOLERY	T AA M F UW L AH R IY
TONGASS	T AA NG AE S
TORMENTER	T AO R M EH N T ER
TRADITIONALISM	T R AH D IH SH AH N AH L IH Z AH M
TRAPDOOR	T R AE P D OW R
TRAWLING	T R AO L IH NG
TRIBALS	T R AY B AH L Z
TRIUMPHING	T R AY AH M F IH NG
TROMPS	T R AA M P S
TUBEROUS	T UW B ER AH S
UBERMOM	Y UW B AH R M AH M
UNACKNOWLEDGED	AH N AE K N AA L IH JH D
UNAPOLOGETICALLY	AH N AH P AA L AH JH EH T IH K AH L IY
UNAPPRECIATIVE	AH N AH P R IY SH IY EY T IH V
UNCLES'	AH NG K AH L Z
UNCOMFORTED	AH N K AH M F ER T IH D
UNCOMPLAINING	AH N K AH M P L EY N IH NG
UNDERFUNDS	AH N D ER F AH N D Z
UNDOCTORED	AH N D AA K T ER D
UNFURNISHED	AH N F ER N IH SH T
UNIVERSITYWIDE	Y UW N AH V ER S AH T IY W AY D
UNLINKED	AH N L IH NG K T
UNLOVING	AH N L AH V IH NG
UNMATCHABLE	AH N M AE CH AH B AH L
UNQUESTIONINGLY	AH N K W EH S CH AH N IH NG L IY
UNSPOOLED	AH N S UW L D
UNSTUDIED	AH N S T AH D IY D
UNTHREATENING	AH N TH R EH T AH N IH NG
URBIS	AH R B AH S
VALERIE'S	V AE L ER IY Z
VEGAS'S	V EY G AH S IX Z
VERIZON'S	V EH R AY Z AH N Z
VERLYNE	V AH R L AY N
VERN'S	V ER N Z
VIJAYASHANKER	V AH JH EY AH SH AE NG K AH R
VOSTRIKOV	V AA S T R AH K AH V
WEIHING	W IY AH NG
WHIRLIGIGS	W AH R L AH JH AH G Z
WHIRLS	W ER L Z
WHISTLEBLOWING	W IH S AH L B L OW IH NG
WIDOWHOOD	W IH D OW HH UH D
WILDLAND	W AY L D L AE N D
WINDIER	W IH N D IY ER
WINEMAKERS	W AY N M EY K ER Z
WIRANTO	W AH R AE N T OW
WISPS	W IH S P S
WOLFED	W UH L F T
WOODCUTTER	W UH D K AH T ER
WORKFARERS	W ER K F EH R ER Z
WORLDCLASS	W ER L D K L AE S
WORTHLESSNESS	W ER TH L AH S N AH S
XIGRIS	Z IH G R AH S
YARDWORK	Y AA R D W ER K
YELLER	Y EH L ER
YELLOWBIRD	Y EH L OW B ER D
YOUTHEN	Y UW TH AH N
ZESTY	Z EH S T IY
